


                                           #
                                          ###
                                         #####
                                        #######
                                       #########
                                      ###########
                                     #############
                                    ###############
                                   #################
                                  ###################
                                 #####################
                                ###                 ###
                                #   ###############   #
                                #   #             #   #
                                #   #             #   #
                                #   #             #   #
                                #   ###############   #
                                #                     #
                                #######################
