

                  ##########                                             ##########
              ###            ###                                     ###            ###
            ##                  ##                                 ##                  ##
           ##                    ##                               ##                    ##
          #                        #                             #                        # 
          #     ####        ####    #                            #                         #
          #    ######      ######   #                            #    ######      ######   #
          #    ######      ######   #                            #    ######      ######   #
          #     ####        ####    #                            #                         # 
          #                        #                             #                        #
           ##                    ##                               ##                    ##
            ##                  ##                                 ##                  ##
              ###            ###                                     ###            ###
                  ##########                                             ##########    
