                                
                                #
                               ###
                              #####
                             #######
                            #########
                           ###########
                          #############
                         ###############
                        #################
                           ###########
                          #############
                         ###############
                        #################
                       ###################
                      #####################
                     #######################
                    #########################
                   ###########################
                        #################       
                       ###################      
                      #####################     
                     #######################     
                    #########################    
                   ###########################   
                  #############################   
                 ###############################   
